SO textures/mc_emerald.xpm
NO textures/north.xpm
WE textures/west.xpm
EA textures/east.xpm

F 0,255,255
C 255,0,255

11111111
10000001
10000S01
10000001
10000001
10000001
10000001
10000001
10000001
11111111
