NO ./textures/zelda.xpm
SO ./textures/zelda.xpm
WE ./textures/zelda.xpm
EA ./textures/zelda.xpm


F 0,128,136
C 0,0,0

                11111111111111111111111111111111
                11111111111111111111111111111111
                11000000000000111100000000000011
                11000000100000111101110000111011
                11000001010000111101000000001011
                11000010001000000001011111101011
                11000001010000111101000000001011
                11000000100000111101110000111011
                11000000000000111100000000000011
                11111111111111111111111001111111
                11111111111111111111111001111111
                                1111111001111111                11111111111111111111111111111111
                                1111111001111111                11111111111111111111111111111111
                                1111111001111111                11000000011111111100000000000011
                                1110001000010111                11000000000111111101111111111011
                                1110101011010111                11000000000011111101001001001011
                                1100101001010011                11000000000000000001010000101011
                                1110101101010111                11000000000011111101000000001011
                                1110100001000111                11000000000111111101111001111011
                                1111111001111111                11000000011111111100000000000011
                                1111111001111111                11111110011111111111111111111111
                                1111111001111111                11111110011111111111111111111111
11111111111111111111111111111111111111100111111111111111111111111111111001111111
11111111111111111111111111111111111111100111111111111111111111111111111001111111
11000000000000111100000000000011110000000000001111000000000000111100000000000011
11000000000000111100000000000011110110000001101111000000000000111101010110101011
11000000000000111100000000000011110000000000001111001000000100111100000000000011
11000000000000000000000100000000000000011000000000000000000000000001010110101011
11000000000000111100000000000011110000000000001111001000000100111100000000000011
11000000000000111100000000000011110110000001101111000000000000111101010110101011
11000000000000111100000000000011110000000000001111000000000000111100000000000011
11111111111111111111111001111111111111100111111111111110011111111111111111111111
11111111111111111111111001111111111111100111111111111110011111111111111111111111
                111111100111111111111110011111111111111001111111
                111111100111111111111110011111111111111001111111
                110000000000001111000000000000111100000000000011
                110000000000001111000000000000111100100000010011
                110000011000001111001000000100111100000000000011
                110000011000000000000000000000000000000000000011
                110000011000001111001000000100111100000000000011
                110000000000001111000000000000111100100000010011
                110000000000001111000000000000111100000000000011
                111111111111111111111110011111111111111111111111
                111111111111111111111110011111111111111111111111
                                1111111001111111
                                1111111001111111
                                1100000000000011
                                1100000000000011
                                1100000110000011
                                1100000110000011
                                1100000110000011
                                1100000000000011
                                1100000000000011
                                1111111001111111
                                1111111001111111
                111111111111111111111110011111111111111111111111
                111111111111111111111110011111111111111111111111
                110000000000001111000000000000111100000000000011
                110000000000001111010010010010111100000000000011
                110000000000001111000000000000111100110000110011
                110000000000000000010010010010000000110000110011
                110000000000001111000000000000111100110000110011
                110000000000001111010010010010111100000000000011
                110000000000001111000000000000111100000000000011
                111111111111111111111110011111111111111111111111
                11111111111111111111111N011111111111111111111111
                                      1111