SO textures/mc_emerald.xpm

NO      textures/north.xpm

WE     textures/west.xpm




EA textures/east.xpm

F 0,255,255
C 255,0,255

11111111
10000001
10000001
10000001
10000001
100E0001
10001001
11111111
