




SO main.c
F 0,0,255




11
11
111
1111111111111111111111111
1111111111111
