




SO main.c
F 0,0,200




11
11
111
1111111111111111111111111