SO main.c



F 0,0,254


11
11
111
1111111111111111111111111
1111111111111000
1111111111

11111111111111111111111111111111
1111111111111111111111
000000000000000000000000000
111111111111111111111111111111


               
