SO textures/mc_emerald.xpm
NO textures/north.xpm
WE textures/west.xpm
EA textures/east.xpm

F 0,255,255
C 255,0,255

11111111
11111111
100000N1
11111111