SO textures/mc_emerald.xpm

NO      textures/north.xpm

WE     textures/west.xpm




EA textures/east.xpm

F 0,255,255
C 255,0,255

111111111111111111111
1N0011000000000000001
100000000000000000001
100000000000000000001
100000000000000000001
100000000000000000001
100000000000000000001
100000000000000000001
100000000000000000001
100000000000000000001
100000000000000000001
100000000000000000001
100000000000000000001
100000000000000000001
111111111111111111111